#resources
#index = resource. 0= gold  1= iron  2= stone  3= wood  4= water  5= food  6= population.
199999999 199999999 1999999999 199999999 199999999 199999999 199999999
#time {day, hour}
-1 -1
#map
0 0 0 0 7 1 1 1 1 6 0 0 0 0 0 0 0 0 0 0 0 0 0 0 0 0 0 0 0 0 0 0 0 
0 0 7 1 12 15 15 22 15 11 6 0 0 7 1 1 1 6 0 0 0 0 0 0 0 0 0 0 0 0 0 0 0 
0 7 12 15 16 22 16 16 22 13 4 0 0 2 13 16 22 11 6 0 0 0 0 0 0 0 0 0 0 0 0 0 0 
0 2 15 16 16 16 17 16 16 10 5 0 0 2 15 13 15 13 4 0 0 0 0 0 0 0 0 0 0 0 0 0 0 
0 2 22 15 16 17 15 16 15 4 0 0 0 8 9 15 13 10 5 0 0 0 0 0 0 0 0 0 0 0 0 0 0 
0 2 22 16 15 16 22 18 16 4 0 0 0 0 8 3 3 5 0 0 0 0 0 0 0 0 0 7 1 1 1 6 0 
0 2 15 22 16 15 16 15 16 4 0 0 0 0 0 0 0 0 0 0 0 0 0 0 0 7 1 12 22 22 16 11 6 
0 8 3 9 15 15 15 10 3 5 0 0 0 0 0 0 0 0 0 0 0 0 0 0 7 12 15 22 22 16 15 15 4 
0 0 0 8 3 3 3 5 0 0 0 0 0 0 0 0 0 0 0 0 7 1 1 1 12 15 15 15 22 15 15 22 4 
0 0 0 0 0 0 0 0 0 0 7 1 1 1 1 6 0 7 1 1 12 16 16 15 15 15 22 15 16 14 15 16 4 
0 0 0 0 0 0 0 0 0 7 12 15 15 15 15 11 1 12 16 22 15 13 14 14 22 15 15 15 15 16 16 16 4 
0 0 0 0 0 0 0 0 0 2 22 15 18 15 15 15 22 18 15 15 15 15 14 16 16 15 15 15 15 16 15 10 5 
0 0 0 0 0 0 0 0 0 2 22 22 15 18 15 15 15 15 15 15 13 15 13 15 15 15 15 15 16 15 13 4 0 
0 0 0 0 0 0 0 0 7 12 16 22 22 15 15 15 15 22 14 14 13 13 15 13 15 15 15 15 13 13 13 4 0 
0 0 0 0 0 0 0 0 2 16 16 16 13 22 15 16 15 10 3 3 9 13 13 13 15 10 3 3 3 9 13 4 0 
0 0 0 0 0 0 0 0 8 3 3 3 3 3 9 10 3 5 0 0 8 3 3 3 3 5 0 0 0 8 3 5 0 
0 0 0 0 0 0 0 0 0 0 0 0 0 0 8 5 0 0 0 0 0 0 0 0 0 0 0 0 0 0 0 0 0 
#