#resources
#index = resource. 0= gold  1= iron  2= stone  3= wood  4= water  5= food  6= population.
0 0 0 0 0 0 0
#time {day, hour}
0 0
#map
0 0 0 0 7 1 1 1 1 6 0 0 0 0 0 0 0 0 0 0 0 0 0 0 0 0 0 0 0 0 0 0 0 0
0 0 7 1 12 13 13 13 15 11 6 0 0 7 1 1 1 6 0 0 0 0 0 0 0 0 0 0 0 0 0 0 0 0
0 7 12 13 16 13 16 16 13 13 4 0 0 2 13 16 13 11 6 0 0 0 0 0 0 0 0 0 0 0 0 0 0 0
0 2 13 16 16 16 17 16 16 10 5 0 0 2 19 13 15 13 4 0 0 0 0 0 0 0 0 0 0 0 0 0 0 0
0 2 15 13 16 17 15 16 13 4 0 0 0 8 9 13 13 10 5 0 0 0 0 0 0 0 0 0 0 0 0 0 0 0
0 2 15 16 15 16 13 18 16 4 0 0 0 0 8 3 3 5 0 0 0 0 0 0 0 0 0 7 1 1 1 6 0 0
0 2 13 13 16 13 16 15 13 4 0 0 0 0 0 0 0 0 0 0 0 0 0 0 0 7 1 12 22 22 13 11 6 0
0 8 3 9 13 13 15 10 3 5 0 0 0 0 0 0 0 0 0 0 0 0 0 0 7 12 31 31 13 13 13 13 4 0
0 0 0 8 3 3 3 5 0 0 0 0 0 0 0 0 0 0 0 0 7 1 1 1 12 31 32 13 30 13 13 13 4 0
0 0 0 0 0 0 0 0 0 0 7 1 1 1 1 6 0 7 1 1 12 16 13 13 13 22 13 13 13 21 13 31 4 0
0 0 0 0 0 0 0 0 0 7 12 15 15 15 13 11 1 12 13 13 13 13 20 21 13 13 13 13 15 19 31 32 4 0
0 0 0 0 0 0 0 0 0 2 13 13 29 15 15 13 13 28 13 15 13 13 21 13 13 23 15 15 15 15 15 10 5 0
0 0 0 0 0 0 0 0 0 2 13 13 15 29 15 15 13 13 15 19 13 13 13 15 15 15 15 15 15 24 13 4 0 0
0 0 0 0 0 0 0 0 7 12 16 13 13 15 13 13 15 13 13 13 19 13 13 13 15 15 13 15 13 13 13 4 0 0
0 0 0 0 0 0 0 0 2 16 16 16 13 13 13 16 13 10 3 3 9 13 13 13 13 10 3 3 3 9 13 4 0 0
0 0 0 0 0 0 0 0 8 3 3 3 3 3 9 10 3 5 0 0 8 3 3 3 3 5 0 0 0 8 3 5 0 0
0 0 0 0 0 0 0 0 0 0 0 0 0 0 8 5 0 0 0 0 0 0 0 0 0 0 0 0 0 0 0 0 0 0
#
